6 10
|--------|
|F.P|...P|
|........|
|F....@|.|
|......|.|
|--------|